{
  "grid": [
    [3, 3, 3, 3, 3, 3, 3, 3, 3, 3, 3, 3, 3],
    [3, 3, 3, 3, 3, 3, 3, 3, 3, 3, 3, 3, 3],
    [3, 3, 3, 3, 3, 3, 3, 3, 3, 3, 3, 3, 3],
    [3, 3, 3, 1, 1, 1, 1, 1, 1, 1, 3, 3, 3],
    [3, 3, 3, 1, 1, 1, 1, 1, 1, 1, 3, 3, 3],
    [3, 3, 3, 1, 1, 1, 1, 1, 1, 1, 3, 3, 3],
    [3, 3, 3, 1, 1, 1, 2, 1, 1, 1, 3, 3, 3],
    [3, 3, 3, 1, 1, 1, 1, 1, 1, 1, 3, 3, 3],
    [3, 3, 3, 1, 1, 1, 1, 1, 1, 1, 3, 3, 3],
    [3, 3, 3, 1, 1, 1, 1, 1, 1, 1, 3, 3, 3],
    [3, 3, 3, 3, 3, 3, 3, 3, 3, 3, 3, 3, 3],
    [3, 3, 3, 3, 3, 3, 3, 3, 3, 3, 3, 3, 3],
    [3, 3, 3, 3, 3, 3, 3, 3, 3, 3, 3, 3, 3]
  ],
  "enemies": [
    { "row": 4, "col": 1, "dir": "right", "type": "basic", "cadence": 1.5, "speed": 0.5 },
    { "row": 10, "col": 1, "dir": "right", "type": "basic", "cadence": 1.5, "speed": 0.5 }
  ]
}
